####################
#.........#........#
#.....#.........####
#..####.....#...#..#
#..#...##...##.....#
#..#...............#
#..#...####........#
#...........####...#
#.....##....#......#
#..#........#...####
#..##..##.###......#
#...#..............#
#...####..#..#.....#
#......#.....#.....#
####################

