####################
#..................#
#.....#.........####
#..####.....#...#..#
#..#........##.....#
#..#...............#
#..#...####........#
#...........####...#
#.....##....#......#
#..#........#......#
#..##.....###......#
#...#..............#
#...####.....#.....#
#............#.....#
####################

