####################
#.........#........#
#.....#.........####
#..####.....#...#..#
#..#...##...##..#..#
#..#............#..#
#..#...####........#
#...........####...#
#.....##....#......#
#..#........#...####
#..##..##.###......#
#...#..............#
#...####..#..##....#
#......#.....#.....#
####################

